0;0;0;0;0;0;0;0;1;1;1;1;1;1;1;1;1;0;0;0;0;0;0;0;0;0;0;0;0;0;0;0;0;0;0;0;0;0;0;0;0;0;0;0;0;0;0;0;0;0;4
0;0;0;0;0;0;0;0;0;1;1;1;1;0;0;0;0;0;7;0;0;0;0;0;0;0;0;0;0;8;9;0;0;0;0;0;0;0;0;0;0;0;0;0;0;0;0;0;0;0;4
0;0;0;0;0;0;0;0;0;0;0;0;0;0;0;0;7;0;0;0;0;0;0;0;0;0;0;0;8;1;0;0;0;0;0;0;0;8;1;9;0;0;0;0;0;0;0;0;0;0;4
0;0;0;0;0;0;0;0;0;0;0;0;0;0;0;0;0;0;0;0;0;8;0;0;0;0;0;8;1;0;0;0;0;0;8;9;0;0;0;0;0;0;0;0;0;0;0;0;0;0;4
0;0;0;0;0;0;0;0;0;0;0;0;0;7;0;0;0;0;0;0;8;1;0;0;0;0;8;1;0;0;0;0;0;0;0;0;0;0;0;0;0;0;0;0;0;0;0;0;0;0;4
0;0;0;0;0;0;0;0;0;0;7;0;0;0;0;0;0;0;0;0;1;1;0;0;0;8;1;0;0;0;0;0;0;8;9;0;0;0;0;0;8;9;0;0;0;0;0;0;0;0;4
1;1;9;0;0;0;0;0;0;0;0;0;0;0;0;0;0;0;0;0;1;1;9;0;0;0;0;0;0;0;0;0;0;0;0;0;0;0;0;0;1;1;1;9;0;0;0;0;8;1;4
1;1;1;9;0;0;8;1;1;1;1;1;1;6;6;6;6;6;6;1;1;1;1;1;1;1;1;1;1;9;0;0;0;0;8;9;0;0;0;0;1;1;1;1;1;6;6;1;1;1;4
1;1;1;1;1;1;1;1;1;1;1;1;1;1;1;1;1;1;1;1;1;1;1;1;1;1;1;1;1;1;1;1;6;6;6;6;6;6;6;1;1;1;1;1;1;1;1;1;1;1;4
0;0;0;0;0;0;0;0;0;0;0;0;0;0;0;0;0;0;0;0;0;0;0;0;0;0;0;0;0;0;0;0;0;0;0;0;0;0;0;0;0;0;0;0;0;0;0;0;0;0;0
